111111111111111
1C0P000000000C1
101010100000001
100C000011000C1
101111001111111
101111001111111
1C00000000000C1
101010100000001
100C001111000C1
101111111111101
1C00000000000C1
100000000000001
100000000000001
100000000000001
1000000E0000001
111111111111111
