111111111111111
1C0P0E0000000C1
101010100000001
100C000011000C1
111111001111111
111111001111111
1C00000000000C1
101010100000001
100C001111000C1
111111111111111
100000000000001
100000000000001
100000000000001
100000000000001
111111111111111
