1111111
1C0P0E1
1010101
100C001
1111111