11111111111111111111111111111111111111111111111111111111111111111111111111111111111111111
1P00000000000000000000000000000E000000000000000000000000000000000111111111111111111111111
10000000000000000000000000000000000000000000000000000000000000000111111111111111111111111
10000000000000000000000000000000000000000000000000000000000000000111111111111111111111111
1C000000000000000000000000000000000000000000000000000000000000000111111111111111111111111
10000000000000000000000000000000000000000000000000000000000000000111111111111111111111111
1C000000000000000000000000000000000000000000000000000000000000000111111111111111111111111
10000000000000000000000000000000000000000000000000000000000000000111111111111111111111111
1C000000000000000000000000000000000000000000000000000000000000000111111111111111111111111
10000000000000000000000000000000000000000000000000000000000000000111111111111111111111111
1C000000000000000000000000000000000000000000000000000000000000000111111111111111111111111
10000000000000000000000000000000000000000000000000000000000000000111111111111111111111111
1C000000000000000000000000000000000000000000000000000000000000000111111111111111111111111
10000000000000000000000000000000000000000000000000000000000000000111111111111111111111111
1C000000000000000000000000000000000000000000000000000000000000000111111111111111111111111
10000000000000000000000000000000000000000000000000000000000000000111111111111111111111111
1C000000000000000000000000000000000000000000000000000000000000000111111111111111111111111
10000000000000000000000000000000000000000000000000000000000000000111111111111111111111111
1C000000000000000000000000000000000000000000000000000000000000000111111111111111111111111
10000000000000000000000000000000000000000000000000000000000000000111111111111111111111111
1C000000000000000000000000000000000000000000000000000000000000000111111111111111111111111
10000000000000000000000000000000000000000000000000000000000000000111111111111111111111111
1C000000000000000000000000000000000000000000000000000000000000000111111111111111111111111
10000000000000000000000000000000000000000000000000000000000000000111111111111111111111111
1C000000000000000000000000000000000000000000000000000000000000000111111111111111111111111
10000000000000000000000000000000000000000000000000000000000000000111111111111111111111111
1C000000000000000000000000000000000000000000000000000000000000000111111111111111111111111
10000000000000000000000000000000000000000000000000000000000000000111111111111111111111111
1C000000000000000000000000000000000000000000000000000000000000000111111111111111111111111
10000000000000000000000000000000000000000000000000000000000000000111111111111111111111111
1C000000000000000000000000000000000000000000000000000000000000000111111111111111111111111
10000000000000000000000000000000000000000000000000000000000000000111111111111111111111111
1C000000000000000000000000000000000000000000000000000000000000000111111111111111111111111
10000000000000000000000000000000000000000000000000000000000000000111111111111111111111111
1C000000000000000000000000000000000000000000000000000000000000000111111111111111111111111
10000000000000000000000000000000000000000000000000000000000000000111111111111111111111111
1C000000000000000000000000000000000000000000000000000000000000000111111111111111111111111
10000000000000000000000000000000000000000000000000000000000000000111111111111111111111111
1C000000000000000000000000000000000000000000000000000000000000000111111111111111111111111
10000000000000000000000000000000000000000000000000000000000000000111111111111111111111111
1C000000000000000000000000000000000000000000000000000000000000000111111111111111111111111
10000000000000000000000000000000000000000000000000000000000000000111111111111111111111111
1C000000000000000000000000000000000000000000000000000000000000000111111111111111111111111
10000000000000000000000000000000000000000000000000000000000000000111111111111111111111111
1C000000000000000000000000000000000000000000000000000000000000000111111111111111111111111
10000000000000000000000000000000000000000000000000000000000000000111111111111111111111111
1C000000000000000000000000000000000000000000000000000000000000000111111111111111111111111
10000000000000000000000000000000000000000000000000000000000000000111111111111111111111111
1C000000000000000000000000000000000000000000000000000000000000000111111111111111111111111
10000000000000000000000000000000000000000000000000000000000000000111111111111111111111111
1C000000000000000000000000000000000000000000000000000000000000000111111111111111111111111
10000000000000000000000000000000000000000000000000000000000000000111111111111111111111111
1C000000000000000000000000000000000000000000000000000000000000000111111111111111111111111
10000000000000000000000000000000000000000000000000000000000000000111111111111111111111111
1C000000000000000000000000000000000000000000000000000000000000000111111111111111111111111
10000000000000000000000000000000000000000000000000000000000000000111111111111111111111111
1C000000000000000000000000000000000000000000000000000000000000000111111111111111111111111
10000000000000000000000000000000000000000000000000000000000000000111111111111111111111111
1C000000000000000000000000000000000000000000000000000000000000000111111111111111111111111
11111111111111111111111111111111111111111111111111111111111111111111111111111111111111111
