NO ./xpm/north.xpm
SO ./xpm/south.xpm

WE ./xpm/west.xpm
EA ./xpm/east.xpm

F 219,57,237
C 57,117,237

111111111
100000001
1N0111001
100201001
100111001
100000001
111111111
