WE ./xpm/wall_vertical.xpm
EA ./xpm/wall_vertical.xpm

NO ./xpm/wall_horizontal.xpm
SO ./xpm/wall_horizontal.xpm

F 220,100,0
C 225,30,0

111111111111111111111111111111
100000000000000000000000000001
1000000000000000100000000000011111111111111
1000000000000000111000000000000000000000001
10000000000000001 1E00000000011111111111001
100000000000000011100000000001         1001
100000000000000000000000000001         0001
1000000000000000000000000000011111111111001
1000000000000000000000000000000000000000001
1111111111111111111111111111111111111111111
