
F 220,  100,    0

WE         ./xpm/wall_vertical.xpm


EA  ./xpm/wall_vertical.xpm

NO      ./xpm/wall_horizontal.xpm



SO    ./xpm/wall_horizontal.xpm


C 225,  30,     0

111111111111111111111111111111
100000000000000000000000000001
100000000000000010000000000001
100000000000000011100000000001
1000000000000000101E0000000001
100000000000000011100000000001
100000000000000000000000000001
100000000000000000000000000001
100000000000000000000000000001
111111111111111111111111111111
