WE ./xpm/west.xpm
EA ./xpm/east.xpm

NO ./xpm/north.xpm
SO ./xpm/south.xpm

F 219,57,237
C 57,117,237

11111111111111111111111111
1N0000000000000000000001
100000000000000000000001
10000000113110000000000111
10000000300030000010000111
100000001131100000100001
100000000000000000000001
11111111111111111111111111
